State,YEAR,Less_than_9th_ grade,9th_to_12th_grade_no_diploma,High_school_graduate_(includes_equivalency),"Some_college,_no_degree",Associates_degree,Bachelors_degree,Graduate_or_professional_degree,Population
Alabama,2019,130320,302753,1039241,700473,301914,547975,337382,3360058
Alaska,2019,10424,20666,139156,124261,43394,89583,56574,484058
Arizona,2019,252459,360539,1170685,1236845,431854,931038,561120,4944540
Arkansas,2019,94376,160617,710306,444052,151738,307185,168182,2036456
California,2019,2346235,1955278,5546711,5542372,2118792,5889724,3538760,26937872
Colorado,2019,127702,174518,836590,805570,334961,1057825,637777,3974943
Connecticut,2019,99132,132707,668361,410972,190700,549166,445382,2496420
Delaware,2019,23925,42597,207642,128063,56885,134287,93912,687311
Florida,2019,712764,1081871,4396122,3001381,1538727,2982643,1770994,15484502
Georgia,2019,319929,536096,1939945,1414554,568130,1410395,891173,7080222
Hawaii,2019,36278,39700,273421,205964,106096,219979,115230,996668
Idaho,2019,34969,64937,305274,304578,124584,220189,116466,1170997
Illinois,2019,388348,494289,2255611,1737416,710058,1886240,1222732,8694694
Indiana,2019,162057,306026,1526825,896654,397627,777771,435055,4502015
Iowa,2019,57894,98587,658822,433870,251578,420199,202054,2123004
Kansas,2019,63799,93958,504035,430549,173251,414851,237638,1918081
Kentucky,2019,154759,235894,1012643,619035,260188,453040,312883,3048442
Louisiana,2019,138644,302200,1066026,646746,202310,503947,280328,3140201
Maine,2019,20783,46531,311108,184723,99008,205722,123277,991152
Maryland,2019,168321,233831,1030636,753547,287293,911781,798449,4183858
Massachusetts,2019,203412,217529,1158066,729016,360810,1197208,984535,4850576
Michigan,2019,186035,410252,2005981,1572770,648794,1252685,818110,6894627
Minnesota,2019,103730,141960,939997,785721,442578,942830,490396,3847212
Mississippi,2019,91377,199540,598609,440939,207448,270712,171039,1979664
Missouri,2019,122379,269436,1308859,900486,333721,775808,495473,4206162
Montana,2019,12087,30595,211079,169641,69400,171309,77839,741950
Nebraska,2019,43627,57645,326389,280333,141189,277159,145428,1271770
Nevada,2019,109903,171012,593417,525746,187469,355837,193082,2136466
New Hampshire,2019,19331,46341,275105,174078,96658,224636,143601,979750
New Jersey,2019,287999,311620,1666321,974540,398984,1555781,995984,6191229
New Mexico,2019,82436,118892,376390,324141,129531,221281,173317,1425988
New York,2019,795539,898691,3524192,2075506,1204588,2898440,2267778,13664734
North Carolina,2019,299154,519770,1839042,1480044,727882,1471420,849765,7187077
North Dakota,2019,13284,19735,134432,112811,70716,108527,44870,504375
Ohio,2019,221017,519830,2627758,1622014,702601,1464945,891640,8049805
Oklahoma,2019,100954,202312,825284,596289,207896,447888,238621,2619244
Oregon,2019,98217,160182,687243,741058,269102,627911,404405,2988118
Pennsylvania,2019,273775,538057,3103046,1420062,775694,1761627,1155775,9028036
Rhode Island,2019,37697,42510,212282,129984,64204,156087,104188,746952
South Carolina,2019,132646,283032,1015260,725158,352549,656496,398063,3563204
South Dakota,2019,16462,29832,176644,120476,69831,121231,53553,588029
Tennessee,2019,202493,360324,1480753,953282,348886,845100,503124,4693962
Texas,2019,1436483,1445905,4734422,3976607,1402600,3750797,2025736,18772550
Utah,2019,46767,86293,442206,486888,184777,448109,216552,1911592
Vermont,2019,9568,21290,129254,74468,38706,101015,71257,445558
Virginia,2019,222224,362488,1387610,1107258,468107,1312800,1012270,5872757
Washington,2019,187558,252516,1167347,1199747,527524,1204728,750904,5290324
West Virginia,2019,53606,111199,515431,229877,101267,161686,108020,1281086
Wisconsin,2019,98802,192060,1223392,804271,438381,829878,428501,4015285
Wyoming,2019,6546,14704,117501,93505,44034,73183,40374,389847
Alabama,2018,131592,316587,1026976,721987,288285,536086,315951,3337464
Alaska,2018,12023,20421,137293,129250,39938,89635,56793,485353
Arizona,2018,256545,349389,1159297,1208158,428422,898032,540461,4840304
Arkansas,2018,92515,166471,686867,450668,154143,296422,174853,2021939
California,2018,2396226,1958791,5559362,5589646,2140543,5704852,3466224,26815644
Colorado,2018,127663,189453,812615,815752,329255,1013989,611560,3900287
Connecticut,2018,97719,128535,669967,413974,195971,544028,443202,2493396
Delaware,2018,26223,42858,225797,120182,51648,124178,88814,679700
Florida,2018,708872,1052860,4387954,3015699,1489510,2920459,1726771,15302125
Georgia,2018,308720,557379,1942122,1383144,562774,1362317,861716,6978172
Hawaii,2018,38532,41547,266728,204652,110557,218828,114745,995589
Idaho,2018,40692,63176,318218,292076,113323,213462,102800,1143747
Illinois,2018,403880,510902,2269285,1764774,704851,1833666,1219018,8706376
Indiana,2018,164472,327362,1480040,887129,397824,771811,439255,4467893
Iowa,2018,64952,97697,649269,434337,247997,413442,197098,2104792
Kansas,2018,70905,101128,485753,436532,170965,402368,243775,1911426
Kentucky,2018,160136,240928,990911,631690,261964,442090,311695,3039414
Louisiana,2018,146205,296354,1071772,649675,203074,496634,262019,3125733
Maine,2018,25361,43100,309259,200338,95274,197489,112561,983382
Maryland,2018,155580,240551,1009495,779231,281787,911761,788934,4167339
Massachusetts,2018,211206,235098,1126183,741544,366687,1178868,973142,4832728
Michigan,2018,189891,422533,1972855,1594947,657727,1239251,792642,6869846
Minnesota,2018,101742,151063,921287,791496,445513,920850,477278,3809229
Mississippi,2018,100599,187996,589363,440256,200375,284701,173993,1977283
Missouri,2018,119915,278462,1270247,937269,341000,754906,480988,4182787
Montana,2018,13375,31704,205496,180384,71397,152448,80957,735761
Nebraska,2018,47660,60686,326400,283318,137646,269675,141055,1266440
Nevada,2018,110045,164010,581662,542405,176618,339675,182159,2096574
New Hampshire,2018,23689,42821,269202,178227,99230,217282,140297,970748
New Jersey,2018,290326,317170,1629398,1018104,409253,1535321,989671,6189243
New Mexico,2018,84348,122340,370023,334577,113481,221735,169977,1416481
New York,2018,827890,929474,3546789,2083151,1193573,2846770,2244696,13672343
North Carolina,2018,305097,529783,1802360,1497087,701016,1454678,812123,7102144
North Dakota,2018,16988,21520,129495,109451,74715,110664,37946,500779
Ohio,2018,218264,528136,2625971,1638319,690735,1431014,894596,8027035
Oklahoma,2018,98813,202447,816934,613877,207381,434570,233591,2607613
Oregon,2018,106364,173561,655811,744593,269508,621190,381353,2952380
Pennsylvania,2018,279306,532792,3113998,1432404,773645,1723226,1139256,8994627
Rhode Island,2018,34642,45944,210606,133241,61601,147507,107154,740695
South Carolina,2018,125417,278074,1043630,701181,354718,627144,362191,3492355
South Dakota,2018,16315,28842,180511,115946,70838,117943,52455,582850
Tennessee,2018,206601,358348,1477132,975251,348066,801616,473809,4640823
Texas,2018,1478739,1485230,4627856,3949496,1334999,3627047,1973730,18477097
Utah,2018,47361,94721,423407,462160,191808,427561,224884,1871902
Vermont,2018,8286,20617,127349,78850,38133,103068,69521,445824
Virginia,2018,229799,358586,1398061,1091538,453566,1296041,994416,5822007
Washington,2018,179951,257533,1133822,1197203,533450,1187508,725596,5215063
West Virginia,2018,50504,106081,508339,246501,96253,163614,109489,1280781
Wisconsin,2018,108021,207198,1222475,817650,438602,775533,422543,3992022
Wyoming,2018,7237,19072,113351,103804,44089,66449,39134,393136
Alabama,2017,137386,309557,1029982,709100,278878,528019,316685,3309607
Alaska,2017,14246,25790,133132,126985,42724,86444,52240,481561
Arizona,2017,254700,350198,1136493,1178809,408070,863062,520030,4711362
Arkansas,2017,92735,174807,683285,443935,143522,301294,168820,2008398
California,2017,2459993,1989309,5541182,5641881,2070661,5616449,3359798,26679273
Colorado,2017,129351,190285,815595,798831,313309,994894,579803,3822068
Connecticut,2017,102064,137225,676911,411854,201193,533791,430816,2493854
Delaware,2017,23460,40091,218309,127966,51777,121442,90641,673686
Florida,2017,710891,1035042,4330040,2982278,1507434,2839500,1614992,15020177
Georgia,2017,313025,580411,1936501,1394047,540564,1311611,819867,6896026
Hawaii,2017,34495,42636,280494,204452,106987,216993,111687,997744
Idaho,2017,36681,65058,313029,291857,107505,202800,94858,1111788
Illinois,2017,424494,525386,2272174,1794526,692672,1829903,1167902,8707057
Indiana,2017,161138,343724,1450767,896138,394092,753268,436190,4435317
Iowa,2017,65578,100027,639230,440516,242738,406630,199190,2093909
Kansas,2017,66505,104758,490769,432206,167548,403542,239200,1904528
Kentucky,2017,164235,248251,997060,644270,241585,423916,299636,3018953
Louisiana,2017,152771,311048,1061526,666998,185409,482439,260086,3120277
Maine,2017,25574,49213,300716,184416,100214,193860,117747,971740
Maryland,2017,165505,254504,1020828,788808,285379,889090,763490,4167604
Massachusetts,2017,207140,235318,1163526,743218,360700,1146586,932085,4788573
Michigan,2017,192884,427082,1969839,1594025,649916,1201375,784189,6819310
Minnesota,2017,114437,147197,938908,788988,426760,888880,473246,3778416
Mississippi,2017,94490,211478,595611,431185,198080,265220,163277,1959341
Missouri,2017,129072,298467,1277505,912962,326430,743797,462042,4150275
Montana,2017,16155,34574,203141,170207,65772,157326,76491,723666
Nebraska,2017,48755,60668,331081,291423,128547,263330,135450,1259254
Nevada,2017,107354,165663,592846,518529,165508,340110,173170,2063180
New Hampshire,2017,18164,48396,268564,171011,97978,216750,137142,958005
New Jersey,2017,298109,330076,1696858,1014640,418148,1506899,969808,6234538
New Mexico,2017,80805,112760,370599,333280,117531,211995,164505,1391475
New York,2017,842286,1012659,3634065,2133828,1218132,2794920,2185242,13821132
North Carolina,2017,314734,539055,1800555,1487938,658224,1406739,783940,6991185
North Dakota,2017,13936,21087,130900,111306,66236,108045,44394,495904
Ohio,2017,218232,559456,2661209,1612818,698820,1381934,849416,7981885
Oklahoma,2017,104975,204039,804245,603902,208717,437243,223293,2586414
Oregon,2017,102453,159928,673810,730804,255783,609160,369257,2901195
Pennsylvania,2017,283386,560910,3134497,1416816,747997,1697397,1119839,8960842
Rhode Island,2017,37301,48991,220613,124664,58876,149699,96825,736969
South Carolina,2017,139309,295539,1016072,698438,330153,607024,357316,3443851
South Dakota,2017,16831,30795,176709,126282,62204,109803,51935,574559
Tennessee,2017,200536,359348,1488080,953734,332593,790840,463322,4588453
Texas,2017,1473004,1496019,4552676,3932201,1323957,3510311,1861178,18149346
Utah,2017,50122,93413,408078,469981,172999,416804,215638,1827035
Vermont,2017,9646,22774,127426,73895,37360,98774,69392,439267
Virginia,2017,240260,353117,1396487,1095931,456210,1270190,967026,5779221
Washington,2017,189334,254629,1128284,1203615,514987,1130392,680727,5101968
West Virginia,2017,58192,107069,526652,238487,90494,156378,102078,1279350
Wisconsin,2017,101506,200465,1214914,805492,433324,782676,419854,3958231
Wyoming,2017,7704,19649,114739,98171,40340,67312,39785,387700
Alabama,2016,157797,333897,1011236,711231,271030,506680,308842,3300713
Alaska,2016,10392,22585,133928,129650,40819,90861,50716,478951
Arizona,2016,265215,349224,1105497,1179736,390843,835779,500115,4626409
Arkansas,2016,100157,179465,681969,449709,133315,282608,163225,1990448
California,2016,2556147,2062516,5390935,5602398,2031775,5426164,3234306,26304241
Colorado,2016,128209,192377,822144,787366,322529,934273,558608,3745506
Connecticut,2016,100513,133422,678776,415150,186288,541369,412219,2467737
Delaware,2016,22347,48247,212474,122182,52228,121717,83352,662547
Florida,2016,762762,1092451,4249733,2961148,1429121,2675907,1532549,14703671
Georgia,2016,334607,588019,1884080,1394205,518208,1270275,796001,6785395
Hawaii,2016,36083,43580,277743,212677,104261,211850,104743,990937
Idaho,2016,34434,69695,302866,275485,104375,203363,97047,1087265
Illinois,2016,429910,536517,2250392,1823126,682989,1813840,1128445,8665219
Indiana,2016,164742,346757,1481882,900213,374136,716293,408553,4392576
Iowa,2016,66242,105856,649532,438173,234055,398242,194920,2087020
Kansas,2016,68491,110352,496294,438343,157030,390861,230565,1891936
Kentucky,2016,170725,257735,968299,640040,256369,419081,283260,2995509
Louisiana,2016,160929,325509,1059273,654115,187288,473299,254607,3115020
Maine,2016,25640,48498,318369,187940,94984,181434,109704,966569
Maryland,2016,166606,240623,1046470,779195,268485,860491,760638,4122508
Massachusetts,2016,212315,240370,1156496,734632,363356,1124295,896051,4727515
Michigan,2016,203405,444504,1978343,1598192,626128,1162737,747093,6760402
Minnesota,2016,111658,152230,937937,796712,429762,860125,436859,3725283
Mississippi,2016,94724,216010,603335,438995,177695,264865,161398,1957022
Missouri,2016,137315,292624,1265386,927795,325244,729511,443139,4121014
Montana,2016,13453,37785,206415,168223,66134,148944,71662,712616
Nebraska,2016,51410,61935,328348,281360,129795,261931,129041,1243820
Nevada,2016,122892,157641,585057,516903,156342,308547,163228,2010610
New Hampshire,2016,20623,47275,256245,179277,97488,213461,133217,947586
New Jersey,2016,317182,343494,1706073,1024289,400332,1460518,919284,6171172
New Mexico,2016,84515,118426,370508,323025,116674,215691,162542,1391381
New York,2016,865976,1002316,3574814,2150858,1191816,2749619,2118193,13653592
North Carolina,2016,319570,553627,1775886,1482131,654866,1345615,745490,6877185
North Dakota,2016,13827,23917,134178,109216,67554,107578,38745,495015
Ohio,2016,222209,568107,2639028,1630529,682507,1362205,817476,7922061
Oklahoma,2016,103252,209774,802529,603826,203590,432922,215743,2571636
Oregon,2016,106021,171461,655893,745532,244515,572508,362022,2857952
Pennsylvania,2016,289165,591181,3132444,1431231,730217,1676971,1070766,8921975
Rhode Island,2016,38405,45778,204045,135369,60183,151195,99070,734045
South Carolina,2016,148917,304737,981669,713098,317549,591086,331420,3388476
South Dakota,2016,18275,31736,163910,123619,65093,111002,52259,565894
Tennessee,2016,216289,374024,1465937,959498,328595,756055,426800,4527198
Texas,2016,1529632,1506376,4474711,3869300,1259574,3362678,1773009,17775280
Utah,2016,51995,95408,404605,472108,178193,381130,199805,1783244
Vermont,2016,11087,23483,128767,75872,40499,92871,66984,439563
Virginia,2016,247576,366738,1372836,1116669,438669,1241751,936934,5721173
Washington,2016,192181,266656,1111786,1178772,491450,1098509,657201,4996555
West Virginia,2016,57435,123866,512228,233677,95794,162243,106514,1291757
Wisconsin,2016,106804,210940,1222607,812391,420412,758503,401672,3933329
Wyoming,2016,5751,20940,114624,97961,45601,67845,38072,390794
Alabama,2015,158830,338052,1018063,707979,266452,504626,288250,3282252
Alaska,2015,12121,22495,128052,129326,38113,87869,51547,469523
Arizona,2015,271316,359657,1110871,1155555,382106,788933,468516,4536954
Arkansas,2015,105945,184126,678452,450886,135029,278975,154406,1987819
California,2015,2582757,2060753,5430081,5603279,1992703,5285754,3129936,26085263
Colorado,2015,135573,188280,796984,809037,301203,909032,531744,3671853
Connecticut,2015,104772,137496,678916,417520,187970,535933,412111,2474718
Delaware,2015,24692,47663,194810,130986,52556,117581,84348,652636
Florida,2015,750053,1031199,4201879,2935247,1383565,2620339,1471999,14394281
Georgia,2015,332116,593620,1879302,1382608,496008,1244449,755664,6683767
Hawaii,2015,39945,50050,267568,213206,105951,205033,104161,985914
Idaho,2015,39730,66804,292667,287585,102284,189566,87346,1065982
Illinois,2015,456567,535035,2314192,1804602,698002,1757697,1095843,8661938
Indiana,2015,164941,349195,1496775,900400,364142,697223,390897,4363573
Iowa,2015,66506,105159,664912,444608,236728,377035,179556,2074504
Kansas,2015,71948,111806,501278,446076,158308,384495,214568,1888479
Kentucky,2015,183951,260013,1002541,611050,235061,406865,289309,2988790
Louisiana,2015,159933,316837,1056533,654211,189683,470739,247319,3095255
Maine,2015,27176,52423,314332,184421,93335,187513,102040,961240
Maryland,2015,173874,251792,1029325,789382,266499,866352,725262,4102486
Massachusetts,2015,213496,245853,1184423,748705,362478,1086715,864974,4706644
Michigan,2015,201139,461761,1979472,1593413,622089,1145546,724927,6728347
Minnesota,2015,112193,155113,941170,794499,413953,847584,436423,3700935
Mississippi,2015,112812,209997,605790,438004,179135,253036,153563,1952337
Missouri,2015,145571,308053,1269953,915960,316815,706922,433938,4097212
Montana,2015,14391,31182,222399,161387,60796,144135,72039,706329
Nebraska,2015,47858,62768,331868,292746,125055,244556,127732,1232583
Nevada,2015,125701,157660,549151,512364,159610,304948,158733,1968167
New Hampshire,2015,18249,46392,267078,179983,91199,205513,128800,937214
New Jersey,2015,319454,355305,1757377,1024098,392077,1437307,880766,6166384
New Mexico,2015,92820,118788,369807,325356,106315,198116,166346,1377548
New York,2015,903295,1012572,3615023,2177053,1155067,2727078,2051385,13641473
North Carolina,2015,340573,568846,1785510,1452845,623813,1277412,713645,6762644
North Dakota,2015,18142,18826,135670,111721,64255,105625,37778,492017
Ohio,2015,233766,579508,2664823,1623927,679330,1329009,786107,7896470
Oklahoma,2015,108956,215702,808375,606070,188756,421765,208239,2557863
Oregon,2015,103304,176281,654930,722848,245431,566244,335423,2804461
Pennsylvania,2015,297088,620062,3174802,1423274,739478,1611499,1029524,8895727
Rhode Island,2015,40319,49725,204295,134773,62153,141131,97687,730083
South Carolina,2015,147012,306843,977099,685917,312720,575843,314398,3319832
South Dakota,2015,19422,30620,175958,119929,62294,110562,44323,563108
Tennessee,2015,237285,386520,1482137,915965,300500,719980,431100,4473487
Texas,2015,1559568,1511574,4425654,3816471,1204220,3266266,1689108,17472861
Utah,2015,49949,97817,421822,458040,159609,368302,186410,1741949
Vermont,2015,12303,24166,127127,75070,37916,97824,64248,438654
Virginia,2015,256445,373316,1399157,1127401,426955,1209217,892827,5685318
Washington,2015,191853,256378,1127649,1171141,471400,1059707,611186,4889314
West Virginia,2015,58050,124065,529290,244509,90019,152256,102158,1300347
Wisconsin,2015,116279,219265,1223628,835967,411400,742544,369914,3918997
Wyoming,2015,7773,22652,111830,102246,42212,67108,34926,388747
Alabama,2014,164748,333011,1028665,709158,256777,478058,286349,3256766
Alaska,2014,12625,20628,131987,131559,38086,85634,44630,465149
Arizona,2014,286007,332779,1079812,1138687,376649,765784,456508,4436226
Arkansas,2014,110814,177923,686786,448062,123871,272411,148547,1968414
California,2014,2555427,2038098,5360853,5560560,2002684,5120162,3016508,25654292
Colorado,2014,148162,190720,783816,792924,294629,862158,512054,3584463
Connecticut,2014,102610,142557,680274,421674,184589,527472,412642,2471818
Delaware,2014,21628,49039,199747,123261,50787,116931,78950,640343
Florida,2014,735213,1060480,4151300,2905454,1358245,2448663,1381841,14041196
Georgia,2014,352984,590904,1869967,1389410,462543,1199733,710867,6576408
Hawaii,2014,39436,41453,277667,211542,102149,200315,102024,974586
Idaho,2014,40558,62620,294862,288457,97174,175108,86414,1045193
Illinois,2014,451301,570565,2305681,1807750,670372,1737022,1096385,8639076
Indiana,2014,167710,333960,1488013,914635,367996,682893,387709,4342916
Iowa,2014,63410,98980,654890,441122,233906,383943,186483,2062734
Kansas,2014,73593,109291,498750,453519,153284,381292,211792,1881521
Kentucky,2014,195578,265461,1003583,614385,228473,386963,272738,2967181
Louisiana,2014,174289,328214,1033528,657995,165066,463860,237736,3060688
Maine,2014,29663,49751,310287,194499,93426,185890,95891,959407
Maryland,2014,167204,255410,1043926,776715,265874,841315,712369,4062813
Massachusetts,2014,230539,249308,1161032,730927,365816,1077993,838736,4654351
Michigan,2014,214925,462665,1980847,1576003,618746,1105362,721977,6680525
Minnesota,2014,108766,163742,943377,793963,404201,834094,424440,3672583
Mississippi,2014,113955,222019,585936,450012,167835,254250,156703,1950710
Missouri,2014,145466,308360,1279755,918431,304044,696669,424042,4076767
Montana,2014,15058,36344,213165,170233,57211,135401,68438,695850
Nebraska,2014,53249,65912,333560,283393,126818,247729,114040,1224701
Nevada,2014,117579,167990,540814,494809,154943,291473,151990,1919598
New Hampshire,2014,23781,49222,265993,174993,91285,201723,124307,931304
New Jersey,2014,316827,353099,1729723,1045432,391582,1415973,875295,6127931
New Mexico,2014,90947,126165,362284,321721,109771,206947,155987,1373822
New York,2014,902591,1027984,3599907,2177721,1163427,2651150,2016832,13539612
North Carolina,2014,335030,567696,1772285,1459970,614392,1239857,672707,6661937
North Dakota,2014,15778,21488,133393,112400,64475,94873,36443,478850
Ohio,2014,232917,603114,2666563,1603451,659197,1301747,790471,7857460
Oklahoma,2014,106853,215077,801435,609238,185914,405799,205569,2529885
Oregon,2014,115126,168320,666778,718634,231853,528064,318182,2746957
Pennsylvania,2014,308874,626094,3220327,1434926,700919,1554120,1013605,8858865
Rhode Island,2014,41609,61636,208366,133665,59701,131408,89486,725871
South Carolina,2014,148284,303682,989223,674243,288524,543917,313056,3260929
South Dakota,2014,18921,27453,170122,121974,62802,111108,43108,555488
Tennessee,2014,239689,389302,1473547,908129,296099,717801,400506,4425073
Texas,2014,1542434,1503261,4298854,3847197,1147113,3104847,1644182,17087888
Utah,2014,50703,95821,391862,467335,168810,353832,176371,1704734
Vermont,2014,12156,22891,134352,81955,34024,91472,61429,438279
Virginia,2014,268592,376397,1382376,1120719,408872,1173872,892467,5623295
Washington,2014,193566,264995,1090724,1170624,479799,1005685,579091,4784484
West Virginia,2014,64223,127823,532918,238727,84402,152434,95823,1296350
Wisconsin,2014,115028,221608,1244668,805935,402829,736544,371550,3898162
Wyoming,2014,8369,20473,106759,108417,41611,69557,33776,388962
Alabama,2013,158191,340457,1001134,710602,258110,476016,280937,3225447
Alaska,2013,14292,24385,129029,127054,38486,84038,45375,462659
Arizona,2013,276191,336013,1079149,1090066,374877,741982,446459,4344737
Arkansas,2013,108906,196532,691814,439502,119812,262755,141182,1960503
California,2013,2537411,2070596,5228893,5524197,1980401,4905468,2900266,25147232
Colorado,2013,130184,202200,761103,801294,291173,837913,490368,3514235
Connecticut,2013,110636,144354,673455,435307,184109,508487,408967,2465315
Delaware,2013,24762,48785,196726,123795,48277,108075,79310,629730
Florida,2013,727313,1079856,4042708,2842328,1300616,2409162,1325013,13726996
Georgia,2013,360044,579775,1850063,1372039,477132,1149847,683272,6472172
Hawaii,2013,37445,48920,263311,210920,100056,199229,100022,959903
Idaho,2013,44147,64799,281769,273724,93044,185216,84190,1026889
Illinois,2013,473719,571283,2321273,1812345,654943,1698605,1061497,8593665
Indiana,2013,176925,359121,1478163,918557,352907,655276,371943,4312892
Iowa,2013,64445,107868,670345,437630,226473,370188,171321,2048270
Kansas,2013,75099,111152,498426,460264,146088,374418,206998,1872445
Kentucky,2013,194327,275420,979031,613570,224279,392610,274416,2953653
Louisiana,2013,177123,336513,1019022,653162,164926,453347,230880,3034973
Maine,2013,28083,49678,322855,192438,91720,172498,96690,953962
Maryland,2013,165397,270675,1030851,795361,252612,814992,688813,4018701
Massachusetts,2013,225989,239096,1190870,738371,355093,1037415,817961,4604795
Michigan,2013,219352,483287,1971925,1589120,594224,1089029,698358,6645295
Minnesota,2013,112595,162110,955079,796489,386177,813237,403646,3629333
Mississippi,2013,121974,218520,591240,443330,162584,248488,144918,1931054
Missouri,2013,148190,309497,1276285,916378,305928,685991,405014,4047283
Montana,2013,15112,35369,200303,180310,58287,135518,64270,689169
Nebraska,2013,52968,65545,329595,290983,119325,238160,118632,1215208
Nevada,2013,112938,165020,532452,487858,152516,282283,139817,1872884
New Hampshire,2013,26481,40407,270826,179643,87766,202495,116950,924568
New Jersey,2013,332020,367045,1751336,1019529,390906,1374616,851253,6086705
New Mexico,2013,100692,113754,361553,320668,105811,204226,155142,1361846
New York,2013,907812,1025819,3594712,2159804,1157285,2589891,1983987,13419310
North Carolina,2013,357638,580965,1743595,1446198,574725,1211484,653505,6568110
North Dakota,2013,19005,20778,128539,108110,64445,93470,33468,467815
Ohio,2013,248098,608491,2668826,1599640,639633,1279678,760888,7805254
Oklahoma,2013,109610,223025,809792,587829,179720,402956,193505,2506437
Oregon,2013,111549,165757,655870,711540,228207,521031,310089,2704043
Pennsylvania,2013,313556,638172,3209801,1428581,692226,1540228,986946,8809510
Rhode Island,2013,44100,57643,191854,133377,59867,142598,90517,719956
South Carolina,2013,161339,298753,939047,680531,284604,529944,304598,3198816
South Dakota,2013,19302,27093,172701,122701,62856,104240,42066,550959
Tennessee,2013,245616,384935,1437758,928049,291304,681475,400898,4370035
Texas,2013,1520001,1497796,4207669,3765377,1090662,3044921,1547230,16673656
Utah,2013,48917,92365,382199,464153,159320,348502,174993,1670449
Vermont,2013,14046,23225,133439,73769,35878,93427,62390,436174
Virginia,2013,261041,385383,1380486,1118219,405760,1172309,838026,5561224
Washington,2013,187704,275893,1095589,1157020,449430,984473,555995,4706104
West Virginia,2013,69868,129702,520535,241268,87697,146732,98223,1294025
Wisconsin,2013,119315,233248,1243158,819923,389016,711851,362780,3879291
Wyoming,2013,5641,19196,109099,106714,41261,68225,33778,383914
Alabama,2011,177922,373824,985450,709188,236162,443488,267044,3193078
Alaska,2011,13994,23627,128373,136407,34000,77153,43308,456862
Arizona,2011,261654,340443,1036587,1105144,348197,719546,399652,4211223
Arkansas,2011,121108,194433,693216,426776,113074,254903,139917,1943427
California,2011,2511634,2110457,5150994,5392030,1872437,4697422,2708898,24443872
Colorado,2011,135447,195838,757700,773805,281428,789859,453233,3387310
Connecticut,2011,108358,158336,676513,438018,179119,500103,383956,2444403
Delaware,2011,28532,50984,192931,119828,42602,104599,71644,611120
Florida,2011,749262,1118540,4033074,2761492,1175984,2190780,1238449,13267581
Georgia,2011,368948,620384,1849141,1311569,419954,1119648,619317,6308961
Hawaii,2011,41062,47326,267463,216187,94200,180231,93043,939512
Idaho,2011,45008,68691,275033,268684,88949,174646,77449,998460
Illinois,2011,480820,610761,2351322,1811978,622949,1645334,998530,8521694
Indiana,2011,177743,364064,1509773,889853,334810,628173,351043,4255459
Iowa,2011,75177,114912,670103,432011,211899,358051,165048,2027201
Kansas,2011,76472,108250,516483,455731,137051,365541,192566,1852094
Kentucky,2011,203871,291143,996929,610797,203585,359975,256050,2922350
Louisiana,2011,181476,339225,1024825,643911,155360,415415,212525,2972737
Maine,2011,32045,53521,314456,191100,83864,168605,98946,942537
Maryland,2011,167418,268473,1010843,778659,245892,800177,644195,3915657
Massachusetts,2011,222929,262443,1165691,738697,349778,1004133,758377,4502048
Michigan,2011,228828,509168,2028204,1577887,555968,1037602,650667,6588324
Minnesota,2011,116545,167364,958243,797766,368032,777339,375512,3560801
Mississippi,2011,125696,235234,578273,434694,159186,240726,138899,1912708
Missouri,2011,157386,340886,1260623,918314,286363,656222,388760,4008554
Montana,2011,13638,38609,206699,170070,56859,132946,57972,676793
Nebraska,2011,46699,61065,347223,292447,114551,225822,108305,1196112
Nevada,2011,115683,174436,528392,455886,129688,269461,137414,1810960
New Hampshire,2011,26031,52952,267726,175455,86730,191748,113565,914207
New Jersey,2011,334272,378360,1767217,1037573,368288,1322225,796678,6004613
New Mexico,2011,98343,129382,359628,319658,101180,195527,150468,1354186
New York,2011,900547,1073719,3635549,2150291,1091931,2467536,1878131,13197704
North Carolina,2011,366748,609890,1745251,1396249,558745,1136478,585996,6399357
North Dakota,2011,20051,21538,120688,109215,58753,86615,31285,448145
Ohio,2011,257573,648932,2695735,1633426,602825,1196897,713848,7749236
Oklahoma,2011,117845,220261,774960,595284,172761,396219,191866,2469196
Oregon,2011,109780,171885,662549,709006,215713,486317,289504,2644754
Pennsylvania,2011,317207,674891,3270338,1443263,658863,1443083,906590,8714235
Rhode Island,2011,45849,62562,187966,134592,59485,134049,87763,712266
South Carolina,2011,173282,319721,955509,647172,266173,486569,262106,3110532
South Dakota,2011,22219,28408,168906,124081,52340,97956,43678,537588
Tennessee,2011,262111,414411,1435886,908721,259365,655551,358347,4294392
Texas,2011,1529216,1513011,4099519,3632685,1052281,2847501,1400178,16074391
Utah,2011,50780,104484,381551,444920,148367,322983,155583,1608668
Vermont,2011,11981,23846,131219,77248,36468,93188,60702,434652
Virginia,2011,261250,397638,1388613,1087264,380585,1111225,792269,5418844
Washington,2011,192924,258880,1092508,1132829,445281,925095,535909,4583426
West Virginia,2011,75385,128987,539023,229070,82692,150916,88125,1294198
Wisconsin,2011,130016,239492,1266895,814234,366423,668444,345869,3831373
Wyoming,2011,6925,23238,115521,99998,37078,61815,31033,375608
Alabama,2010,195566,369310,988205,690363,225382,439863,252832,3161521
Alaska,2010,12708,27668,114055,133217,37106,83346,42477,450577
Arizona,2010,261461,333890,1040197,1100225,336950,691889,382146,4146758
Arkansas,2010,121504,205920,664076,432193,121711,252888,121130,1919422
California,2010,2534951,2115091,5012413,5351807,1831667,4610875,2640396,24097200
Colorado,2010,141906,201526,759326,753324,260733,779055,432175,3328045
Connecticut,2010,111914,165094,687618,431411,173047,491990,373309,2434383
Delaware,2010,23093,51028,196159,120045,43386,99400,67668,600779
Florida,2010,751011,1148040,3916584,2768793,1121500,2171876,1199375,13077179
Georgia,2010,362962,616597,1824976,1306500,422830,1093642,608116,6235623
Hawaii,2010,44550,49049,265263,208837,85655,184364,89210,926928
Idaho,2010,41572,73894,282678,267054,81703,165218,75710,987829
Illinois,2010,472627,637864,2336176,1805974,609204,1629625,974292,8465762
Indiana,2010,176191,372087,1521860,884620,315927,617193,341920,4229798
Iowa,2010,79022,111622,681148,440865,202577,344952,158599,2018785
Kansas,2010,81840,117769,511343,445999,135842,354379,193509,1840681
Kentucky,2010,222671,302020,996825,587180,198229,359930,236453,2903308
Louisiana,2010,190254,341622,1012345,619617,151174,424074,206821,2945907
Maine,2010,33514,57273,322397,188163,84698,162350,88619,937014
Maryland,2010,181928,280699,1004589,764665,244750,762917,633926,3873474
Massachusetts,2010,220010,265391,1168464,728540,337594,992307,746592,4458898
Michigan,2010,228553,512569,2032219,1592131,549148,1023760,631421,6569801
Minnesota,2010,115853,173052,963579,799477,353299,760013,362823,3528096
Mississippi,2010,125258,236533,583436,427958,159702,236965,134554,1904406
Missouri,2010,174979,348656,1269737,899999,271659,639352,380467,3984849
Montana,2010,16844,38789,201082,168913,53464,133356,60504,672952
Nebraska,2010,48030,66182,335752,288668,106676,232326,106745,1184379
Nevada,2010,112064,162597,531333,469209,126202,256589,131536,1789530
New Hampshire,2010,25011,52525,270680,171327,90731,185129,112352,907755
New Jersey,2010,322882,390852,1761246,1014776,367832,1321937,791379,5970904
New Mexico,2010,101671,121746,354726,333617,94493,189989,145087,1341329
New York,2010,921410,1060697,3627235,2148659,1072055,2433331,1826461,13089848
North Carolina,2010,354732,610095,1749642,1392117,545716,1123118,550201,6325621
North Dakota,2010,21774,20989,119871,106156,51857,87414,34885,442946
Ohio,2010,254513,660580,2718983,1583538,602445,1210527,690263,7720849
Oklahoma,2010,111530,225692,784855,599946,166649,376600,183941,2449213
Oregon,2010,107150,186987,653316,711777,203853,478133,273670,2614886
Pennsylvania,2010,324917,675770,3246315,1426340,638002,1445223,898262,8654829
Rhode Island,2010,52076,65053,192992,132513,52759,128188,86398,709979
South Carolina,2010,168065,321816,937777,632791,259417,484341,270150,3074357
South Dakota,2010,24758,30457,168427,115589,53362,98760,41026,532379
Tennessee,2010,264801,429041,1422131,882947,263107,621127,359237,4242391
Texas,2010,1533921,1514400,4033241,3598229,1000561,2733721,1358049,15772122
Utah,2010,48943,100093,387683,439793,143171,315627,149514,1584824
Vermont,2010,13129,25627,135729,75936,35790,87638,57193,431042
Virginia,2010,293672,428004,1363946,1078426,361635,1075786,759832,5361301
Washington,2010,185927,273365,1072578,1149227,425322,897884,501354,4505657
West Virginia,2010,78648,138573,538546,237089,75046,140850,85995,1294747
Wisconsin,2010,131242,244183,1265296,803727,354494,659852,341501,3800295
Wyoming,2010,9676,18962,111983,101199,39657,58232,31242,370951
Alabama,2009,187457,370108,966912,686411,218551,447402,239141,3115982
Alaska,2009,13094,23978,119495,127544,32532,75816,38719,431178
Arizona,2009,300596,371724,1057329,1102286,330543,691996,393757,4248231
Arkansas,2009,135600,199817,662671,431876,115017,242389,116544,1903914
California,2009,2505666,2104000,4979576,5284655,1797763,4553969,2556480,23782109
Colorado,2009,152597,198899,743807,754624,261847,762038,419556,3293368
Connecticut,2009,110549,160548,667775,412845,174809,475179,368323,2370028
Delaware,2009,23088,51980,185594,119234,44146,103335,67756,595133
Florida,2009,761436,1122565,3863394,2736290,1083545,2081848,1151866,12800944
Georgia,2009,384005,617932,1799352,1311332,401660,1096655,619390,6230326
Hawaii,2009,40490,44161,254898,194885,87354,173274,87821,882883
Idaho,2009,43648,68379,278026,263001,80424,157721,72531,963730
Illinois,2009,512590,634250,2302533,1791159,615678,1593889,987574,8437673
Indiana,2009,184153,376785,1487584,884718,315650,606497,337823,4193210
Iowa,2009,74123,114143,653961,440140,201612,350245,146673,1980897
Kansas,2009,76067,109573,517000,444050,129360,348274,184730,1809054
Kentucky,2009,226212,300690,981970,577020,187874,358687,244880,2877333
Louisiana,2009,186655,329765,994399,626308,139674,419316,200815,2896932
Maine,2009,34916,55761,317244,186440,81337,160080,89195,924973
Maryland,2009,169104,278281,1013865,747161,234060,748377,606891,3797739
Massachusetts,2009,218237,277073,1181095,749490,347972,980758,735820,4490445
Michigan,2009,247959,553273,2057412,1593646,543759,1005499,623327,6624875
Minnesota,2009,122970,174126,972163,779142,339711,738972,359069,3486153
Mississippi,2009,129781,236219,572627,429597,131978,234032,131628,1865862
Missouri,2009,178547,345958,1267009,908217,262736,623479,375616,3961562
Montana,2009,20223,39200,204204,156247,51322,123649,53983,648828
Nebraska,2009,49685,67979,329580,282947,107574,214419,101046,1153230
Nevada,2009,112885,165047,496477,446068,131339,245697,130726,1728239
New Hampshire,2009,26723,51971,270372,178142,86666,187812,101061,902747
New Jersey,2009,333852,409358,1734474,1025593,364544,1273186,764295,5905302
New Mexico,2009,98470,123311,340607,305548,95854,192548,134582,1290920
New York,2009,920423,1105197,3641890,2153592,1100827,2434198,1841265,13197392
North Carolina,2009,364595,599129,1678361,1350850,524739,1091506,541067,6150247
North Dakota,2009,22024,19603,114416,103913,51444,80126,27909,419435
Ohio,2009,268553,689200,2726971,1622573,564275,1183146,683630,7738348
Oklahoma,2009,118633,224576,756075,578340,158883,364742,175534,2376783
Oregon,2009,106913,175688,624733,712160,212845,484488,269971,2586798
Pennsylvania,2009,336335,703970,3241376,1431746,624436,1394249,877021,8609133
Rhode Island,2009,50175,59376,200988,128201,58849,134035,83941,715565
South Carolina,2009,178324,316566,915789,620592,253400,480232,254430,3019333
South Dakota,2009,23605,29253,169343,119536,50545,93321,38233,523836
Tennessee,2009,271845,438543,1388399,887346,257969,636544,332722,4213368
Texas,2009,1561235,1532431,3906082,3500412,944093,2618635,1298669,15361557
Utah,2009,53133,98211,390291,439777,143646,304181,143940,1573179
Vermont,2009,12932,25401,136581,74288,35647,83936,56698,425483
Virginia,2009,274095,423819,1324689,1071018,344109,1035382,734875,5207987
Washington,2009,174910,283988,1067506,1127788,411431,885861,493867,4445351
West Virginia,2009,81830,135423,518118,234239,76063,133022,85248,1263943
Wisconsin,2009,131462,253239,1283862,789090,338575,648584,316844,3761656
Wyoming,2009,8897,20167,109962,99272,32931,56495,28069,355793
Alabama,2008,188862,368673,974088,659498,210308,439587,237483,3078499
Alaska,2008,12640,22917,112556,126632,34122,74728,41306,424901
Arizona,2008,316397,361708,1048111,1085390,328608,667004,385329,4192547
Arkansas,2008,128766,208194,663108,416282,104524,234355,117585,1872814
California,2008,2501556,2150107,4903309,5222002,1789376,4432116,2530010,23528476
Colorado,2008,157307,206189,746933,742611,248519,748494,412973,3263026
Connecticut,2008,112181,156372,661750,415747,176357,481976,359934,2364317
Delaware,2008,24297,50056,182263,123251,41966,96864,63114,581811
Florida,2008,731563,1145253,3802995,2679496,1061658,2134466,1143981,12699412
Georgia,2008,373002,623597,1817100,1274666,401040,1100034,602432,6191871
Hawaii,2008,41078,43768,250825,198188,85014,167681,86492,873046
Idaho,2008,47792,68562,266100,264545,82006,159133,71024,959162
Illinois,2008,540486,644938,2295552,1795872,608705,1565010,942684,8393247
Indiana,2008,183233,391502,1466600,866304,313410,617092,339279,4177420
Iowa,2008,76461,116428,668417,446292,191386,335245,144995,1979224
Kansas,2008,73036,116470,504656,442830,134503,353290,181665,1806450
Kentucky,2008,229888,306802,989402,588962,192580,337111,228177,2872922
Louisiana,2008,200902,330657,990785,596461,137845,389972,183878,2830500
Maine,2008,34391,61063,324960,188703,83959,153102,82416,928594
Maryland,2008,167730,281531,986866,758376,230850,739285,577157,3741795
Massachusetts,2008,216778,279849,1172132,722384,331517,956049,719218,4397927
Michigan,2008,243295,545208,2064234,1600523,534335,1015678,624495,6627768
Minnesota,2008,122103,168662,950861,791151,333882,744626,344728,3456013
Mississippi,2008,135999,238442,559994,420974,145996,234364,126687,1862456
Missouri,2008,179096,350354,1253360,890733,263099,621851,357356,3915849
Montana,2008,18141,40625,200319,163845,49516,121576,54255,648277
Nebraska,2008,47562,66004,340895,281230,103164,213091,99321,1151267
Nevada,2008,111690,169958,486603,447786,120278,254739,119076,1710130
New Hampshire,2008,28634,53605,262528,173731,83703,192469,108418,903088
New Jersey,2008,319819,420769,1727649,1010266,368268,1266033,751591,5864395
New Mexico,2008,100763,123750,334339,308319,94904,178600,137330,1278005
New York,2008,951328,1127383,3614690,2150948,1054806,2368483,1804706,13072344
North Carolina,2008,383607,612533,1680882,1324936,497276,1060313,525768,6085315
North Dakota,2008,22799,20643,113472,98246,51090,85130,27513,418893
Ohio,2008,263168,684454,2713868,1588371,567394,1179230,667824,7664309
Oklahoma,2008,116194,225218,758273,575467,161141,353517,169540,2359350
Oregon,2008,108211,184787,661252,689472,211680,465367,259786,2580555
Pennsylvania,2008,343289,719606,3164208,1396644,625930,1382175,843480,8475332
Rhode Island,2008,48453,67025,197197,129543,53648,132534,80346,708746
South Carolina,2008,178199,319905,913708,596268,251946,449200,251296,2960522
South Dakota,2008,22389,28169,169985,120891,50505,92952,38098,522989
Tennessee,2008,274993,436130,1359011,900067,251702,620919,333818,4176640
Texas,2008,1571518,1511080,3848003,3411055,951090,2582943,1249157,15124846
Utah,2008,50662,98500,379895,425995,147843,306131,145608,1554634
Vermont,2008,14769,25570,141969,71910,37553,85431,52657,429859
Virginia,2008,291622,433654,1298100,1048511,346881,1027033,709949,5155750
Washington,2008,179874,274759,1041543,1135802,408831,870887,476197,4387893
West Virginia,2008,83851,140851,515881,234325,73953,130855,85349,1265065
Wisconsin,2008,139015,250576,1264002,808721,330632,642270,323394,3758610
Wyoming,2008,8102,20968,106916,95656,35190,54987,27570,349389
Alabama,2007,192991,404339,978130,616909,202115,408600,242809,3045893
Alaska,2007,16268,23868,127441,108709,35925,67754,41853,421818
Arizona,2007,310022,363837,1093262,953739,322378,655897,376690,4075825
Arkansas,2007,134047,217028,663851,377219,109425,239729,120511,1861810
California,2007,2468068,2144680,5396253,4657119,1782118,4425024,2458500,23331762
Colorado,2007,137324,218052,797352,690777,238931,721172,400096,3203704
Connecticut,2007,108277,174151,695183,388199,176018,455313,362427,2359568
Delaware,2007,24183,48004,191244,115727,44904,90173,59700,573935
Florida,2007,712680,1186795,3962460,2422966,1060738,2123627,1118817,12588083
Georgia,2007,374449,664491,1852511,1144966,393747,1068497,576199,6074860
Hawaii,2007,42443,49987,260772,175147,90011,168766,86598,873724
Idaho,2007,36733,73438,282497,239882,82119,159333,72129,946131
Illinois,2007,524936,670454,2432952,1666727,598081,1541417,920420,8354987
Indiana,2007,173481,416755,1542222,803293,293297,586250,328221,4143519
Iowa,2007,78448,126376,702217,402481,185337,330681,148936,1974476
Kansas,2007,69812,124693,541019,406208,132752,339940,175662,1790086
Kentucky,2007,247797,316446,1003985,527113,176547,340467,227671,2840026
Louisiana,2007,197246,353832,979695,530001,122759,378156,181133,2742822
Maine,2007,37405,60066,334985,160550,82539,161545,85142,922232
Maryland,2007,157896,308825,1019051,680723,238061,725785,583146,3713487
Massachusetts,2007,215082,292123,1214179,669274,322793,955812,700156,4369419
Michigan,2007,232946,601586,2154359,1483753,531033,1013139,630313,6647129
Minnesota,2007,127703,179624,980837,752685,327051,719678,341786,3429364
Mississippi,2007,136564,258877,586721,374247,134999,228957,118513,1838878
Missouri,2007,185588,371863,1305247,819279,248346,607464,344751,3882538
Montana,2007,20832,43347,208019,147444,48566,117607,55204,641019
Nebraska,2007,46860,71513,350460,253630,103150,213500,100116,1139229
Nevada,2007,112049,162961,521941,399238,122831,241395,125683,1686098
New Hampshire,2007,26311,58627,277516,160597,81611,188538,102781,895981
New Jersey,2007,322857,436839,1822803,931111,356100,1240638,740578,5850926
New Mexico,2007,105676,119249,364480,274245,89851,185383,128924,1267808
New York,2007,922700,1134653,3793882,1916226,1042663,2345752,1744232,12900108
North Carolina,2007,365783,647904,1766873,1160685,491574,1015979,511109,5959907
North Dakota,2007,24716,20883,117971,93990,49580,79929,26262,413331
Ohio,2007,262920,724622,2805856,1450070,548843,1161216,674088,7627615
Oklahoma,2007,113698,241497,773538,522921,155740,355591,177519,2340504
Oregon,2007,115658,189121,697165,623717,200969,457737,263085,2547452
Pennsylvania,2007,333715,779551,3240835,1283484,619921,1344889,834370,8436765
Rhode Island,2007,54313,66646,205846,118307,53406,128125,83509,710152
South Carolina,2007,173409,348738,954015,519807,231461,445080,237269,2909779
South Dakota,2007,27703,32831,172858,104071,47332,92168,35939,512902
Tennessee,2007,293507,474457,1412303,806306,236833,584565,314722,4122693
Texas,2007,1544740,1552575,4023210,3055685,927185,2512122,1220803,14836320
Utah,2007,47240,99688,398932,386562,133937,293227,136173,1495759
Vermont,2007,14499,26999,139139,67306,35655,88510,55231,427339
Virginia,2007,276257,445751,1390436,946444,332546,1011527,701720,5104681
Washington,2007,171159,291137,1107575,1037633,410420,842952,467060,4327936
West Virginia,2007,88441,148922,517789,211023,76885,135597,82798,1261455
Wisconsin,2007,137200,272669,1300021,742258,328487,629443,317182,3727260
Wyoming,2007,8543,21684,108983,88824,34296,53597,26329,342256
Alabama,2006,199344,401406,986222,597451,201639,403122,233694,3022878
Alaska,2006,15799,26939,119251,111477,30563,72258,39343,415630
Arizona,2006,279577,362226,1056153,945684,303046,643182,363507,3953375
Arkansas,2006,136143,223906,671500,378534,100619,221233,115390,1847325
California,2006,2462134,2143220,5368962,4684571,1767989,4311428,2394870,23133174
Colorado,2006,142859,229951,765604,672932,235974,685736,385444,3118500
Connecticut,2006,114000,169402,704762,409332,172604,456201,341210,2367511
Delaware,2006,27050,54896,192075,100169,39294,93121,59707,566312
Florida,2006,714169,1211194,3880665,2437453,1062507,2044646,1109804,12460438
Georgia,2006,381018,682060,1811581,1119878,387088,1035445,551180,5968250
Hawaii,2006,45599,49180,254442,173058,84657,171316,84767,863019
Idaho,2006,41007,75813,277120,233228,77659,148953,65423,919203
Illinois,2006,547938,697626,2405207,1669963,599632,1505856,899908,8326130
Indiana,2006,189325,419169,1521427,793292,296052,561008,330481,4110754
Iowa,2006,85198,130977,695373,394090,177466,324529,144393,1952026
Kansas,2006,76218,127860,536037,403768,121441,331537,174324,1771185
Kentucky,2006,243156,331564,975858,518154,181645,332480,229915,2812772
Louisiana,2006,199328,364511,961890,532254,122472,367069,186994,2734518
Maine,2006,38411,65536,337675,164873,78612,155686,82535,923328
Maryland,2006,155064,324344,998620,692311,244076,721296,581801,3717512
Massachusetts,2006,215209,309234,1226480,652960,332930,930252,678496,4345561
Michigan,2006,251501,597096,2157157,1492765,514685,1016033,609429,6638666
Minnesota,2006,129127,186905,969471,745042,326228,705316,325359,3387448
Mississippi,2006,142755,263334,588543,365011,134677,232501,112861,1839682
Missouri,2006,200433,384372,1293654,795363,241943,599937,333573,3849275
Montana,2006,22517,40079,201230,142857,50990,119732,53275,630680
Nebraska,2006,47751,71110,351267,260535,99502,210045,95658,1135868
Nevada,2006,104042,161321,520461,398502,118578,223358,118058,1644320
New Hampshire,2006,28309,62414,274960,160429,84344,185549,100867,896872
New Jersey,2006,348272,469904,1785750,947823,355777,1235533,728181,5871240
New Mexico,2006,102572,126938,343109,263979,89009,179016,134810,1239433
New York,2006,892372,1155222,3830283,1932853,1031187,2293158,1710807,12845882
North Carolina,2006,384155,667051,1738948,1129037,474966,966882,484196,5845235
North Dakota,2006,25245,23565,122742,87834,45720,78243,26516,409865
Ohio,2006,273308,772527,2817083,1453587,541151,1115230,629576,7602462
Oklahoma,2006,119138,244070,783807,502628,150495,344470,167513,2312121
Oregon,2006,117998,192548,668558,636657,196595,439070,249946,2501372
Pennsylvania,2006,355247,808760,3277304,1244703,600673,1332252,812920,8431859
Rhode Island,2006,51889,73924,209896,115629,50690,130704,80252,712984
South Carolina,2006,182421,350484,927647,513902,224153,423447,223690,2845744
South Dakota,2006,27917,31199,171524,102693,46367,88911,36626,505237
Tennessee,2006,306372,465643,1388059,773830,229634,571014,303274,4037826
Texas,2006,1525376,1591719,3964551,2969594,904933,2424828,1170693,14551694
Utah,2006,48719,91785,371677,380309,134594,275297,135180,1437561
Vermont,2006,15141,28281,138289,69987,36722,83968,54542,426930
Virginia,2006,283786,458280,1376944,945555,344472,988580,671376,5068993
Washington,2006,174611,292989,1089695,1004645,395303,841454,454885,4253582
West Virginia,2006,89570,150281,539089,202909,72558,125706,82820,1262933
Wisconsin,2006,149482,279369,1282027,721601,324651,616542,308959,3682631
Wyoming,2006,10054,23117,111587,85219,32273,52112,25036,339398
Alabama,2005,187473,393433,941983,594281,196856,398907,231701,2944634
Alaska,2005,13336,21398,112102,105281,29751,66674,39067,387609
Arizona,2005,254418,344114,948896,909182,300033,601547,345165,3703355
Arkansas,2005,124894,212640,631853,374185,98353,223069,112248,1777242
California,2005,2337733,2104465,4868430,4692874,1709579,4215208,2370752,22299041
Colorado,2005,127627,208173,706673,639743,231380,685481,365696,2964773
Connecticut,2005,105949,172524,675701,379272,163904,459099,344116,2300565
Delaware,2005,22774,56553,181831,99866,38176,90574,61305,551079
Florida,2005,650647,1175182,3619623,2428871,997871,1936734,1041854,11850782
Georgia,2005,337445,633007,1669685,1106110,357060,992829,536033,5632169
Hawaii,2005,45985,52974,253116,168334,76867,155858,75783,828917
Idaho,2005,39860,76566,259993,226569,69670,139596,64777,877031
Illinois,2005,504266,649516,2283031,1686652,594479,1480111,881826,8079881
Indiana,2005,173772,406895,1468342,789952,276886,534551,306325,3956723
Iowa,2005,71826,129419,692441,397684,176941,317164,141543,1927018
Kansas,2005,69900,124513,520710,400078,124662,320356,165606,1725825
Kentucky,2005,243034,327649,941493,505651,174123,312484,211371,2715805
Louisiana,2005,189347,355153,977629,567615,127732,375088,199295,2791859
Maine,2005,36453,62591,325305,162818,82032,152744,77593,899536
Maryland,2005,152448,311970,955095,701816,224327,691771,546189,3583616
Massachusetts,2005,210726,298648,1164066,678365,327297,895971,668187,4243260
Michigan,2005,227957,609225,2026459,1482787,516393,977313,614193,6454327
Minnesota,2005,115534,183006,923552,745251,313973,690482,320376,3292174
Mississippi,2005,134480,252751,575561,357965,140767,218351,117209,1797084
Missouri,2005,177717,380255,1249751,804810,222586,572749,321736,3729604
Montana,2005,16008,41391,197873,154981,45384,114067,49842,619546
Nebraska,2005,46883,69650,340138,252426,97911,208864,93964,1109836
Nevada,2005,105851,161869,478672,379073,108486,218353,102619,1554923
New Hampshire,2005,25350,62419,265622,159736,78480,174551,101536,867694
New Jersey,2005,302981,476011,1670430,928107,349036,1232096,708098,5666759
New Mexico,2005,92867,124918,345549,258613,83468,172004,131519,1208938
New York,2005,818654,1147970,3659953,1962759,1033232,2243704,1680229,12546501
North Carolina,2005,353070,631888,1638855,1089224,456290,951509,448053,5568889
North Dakota,2005,24341,24526,119819,93458,46358,77591,27922,414015
Ohio,2005,251923,761400,2715259,1432994,518113,1094740,630832,7405261
Oklahoma,2005,107411,244109,721388,514274,155119,341041,161413,2244755
Oregon,2005,98195,200906,627297,622968,174291,423469,237692,2384818
Pennsylvania,2005,315250,773835,3160932,1254330,576246,1300563,799301,8180457
Rhode Island,2005,44561,71832,205724,118882,57534,125960,80933,705426
South Carolina,2005,166692,331758,856809,519911,222878,409744,215513,2723305
South Dakota,2005,25030,30101,158891,105273,46541,85688,34209,485733
Tennessee,2005,276419,459984,1348744,752512,219264,552189,298554,3907666
Texas,2005,1428385,1498076,3612343,2928191,844048,2335267,1125545,13771855
Utah,2005,38918,97878,361729,373908,128462,266352,120578,1387825
Vermont,2005,16127,28086,134142,69623,35034,84510,51724,419246
Virginia,2005,268057,443013,1297610,924026,318555,964059,650945,4866265
Washington,2005,159155,295192,1023914,996222,373534,800293,426309,4074619
West Virginia,2005,86757,146407,518760,210038,67494,126013,83765,1239234
Wisconsin,2005,136626,265531,1233028,736900,313773,602795,290404,3579057
Wyoming,2005,7618,21150,111970,88126,26487,51488,25456,332295
